################
#      ~~~~~   #
#      ~~~~~   #
#      ~~~~~   #
#      ~~~~~   #
#      #####   #
#          #   #
#          #   #
#   #      #   #
#   #      #   #
################