################
#              #
#              #
#              #
#     ##       #
#    #  #      #
#     # #      #
#   # #  # #   #
#   #      #   #
################